S##.####
..#T.E##
#.#G#...
#.#####.
#..E..T.
